NO textures/wall_no.xpm
SO textures/wall_so.xpm
WE textures/wall_we.xpm
EA textures/wall_ea.xpm

F 164,169,20
C 153,204,255

111111111111111
100000000000001
101111011111101
100001010000001
111101010111101
100001000100001
101111110101101
1000000001000N1
101101111101101
101100000001101
100001111100001
111100000001111
100001111100001
100000000000001
111111111111111