NO textures/wall_no.xpm
SO textures/wall_so.xpm
WE textures/wall_we.xpm
EA textures/wall_ea.xpm

F 164,169,20
C 153,204,255

111111111111111111111
100000001000000000001
101010100101111111001
100010100010000010N01
111110101111101011101
100000101000101000001
10111111011101111111
101000001010100000101
101011111010111110101
101010001000100010101
101110101010101010101
100000101010001010001
111111101011111011101
100000101000100010001
101110101110101110111
101000100000100010101
101011111111111010101
100010000000000010001
101010111011111111101
101000001000000000001
111111111111111111111