NO textures/wall_no.xpm
SO textures/wall_so.xpm
WE textures/wall_we.xpm
EA textures/wall_ea.xpm

F 80,80,80
C 120,180,255

111111111111111111
100000000000000001
101111011111110101
1000010D0000010101
111101011111101101
100001000000100001
101111110D11011101
1000000001000000E1
101101111101111101
101100000001000001
1000011111010D1101
111100000001000001
100001111111011101
100000000000000001
111111111111111111