NO textures/wall_no.xpm
SO textures/wall_so.xpm
WE textures/wall_we.xpm
EA textures/wall_ea.xpm

F 35,35,35
C 180,210,255

111111111111111111111
100000000100000000001
101111110101111111101
101000010D01000000001
101011110101011111101
100010000001010000101
111010111111010D10101
100010100000010010101
101110101111110010101
1000001000000000100S1
101111111011111110101
101000000010000000101
101011111110111111101
101000000000100000001
101111D111110101111101
100000000000101000001
101111111110101011101
10000000001000D00001
111111111111111111111