NO textures/wall_no.xpm
SO textures/wall_so.xpm
WE textures/wall_we.xpm
EA textures/wall_ea.xpm


F 164,169,20
C 153,204,255

111111111111111111111
100000000000000000001
100000001111000000001
100000010000100000001
100000010E00000000001
100000010000100000001
100000001111000000001
100000000000000000001
111111111111111111111